0000000000000000000000000000000
0111111111111111111111111111110
0100000000000000000000000000010
0100000000000000000000000000010
0100000000000000000000000000010
0100000000000000000000000000010
0100000000000000000000000000010
0100000000000000000000000011110
0100000000000000300000000004440
0100000000000000000000000004440
0111111111111111111111111111110
0000000000000000000000000000000