11111111111111111111111111111
00000000000000000000100000001
00000000000000000000100000001
11111111111111111000111110011
11111111111111111000111110011
11111111111111111000000000011
11111111111111111000000000011
11111111111111111111111111111
