11111111111111111111100000001
10000000000000000000100000001
10000000000000000000100000001
10000000000000000000100000001
10000000003000000000111111111
10000000000000000000000000001
10000000000000000000000000001
11111111111111111111111111111