111111111111111111111111111111111
100000000000000000000000000000001
100000000000000001100000000000001
100000000000000000100000000000001
100011111111111111100000000000001
100000000000011000000000000000001
100000000000000000000000000000001
100000000000000000000000000000001
100000000000000000001111000000001
100000000000000000000000000000001
100000000000000000000000000000001
100000000003000000000000000000001
100000000000000000000000000000001
111111111111111111111111111111111