11111111111111111111111111000000000000
10000000000000000000000001111111111111
10000000000000000000000001000000000001
10000000000000000000000001000000000001
10000000030000000000000000000000000001
10000000000000000000000000000000000001
10000000000000000000000000000000000001
10000000000000000000000001000000000000
10000000000000000000000001000000000000
10000000000000000000000001000000000000
11111111111111111111111111111111111111